2 2 2 2 2 2 2 2 2 2 2 2 2 2 2 2
2 2 2 2 2 2 2 2 2 2 2 2 2 2 2 2
10 6 6 6 6 6 6 6 6 6 6 6 6 6 6 5
1 2 2 2 2 2 2 2 2 2 2 2 2 2 2 1
1 0 13 0 0 0 0 0 0 0 0 0 0 0 0 1
1 0 0 0 0 0 0 0 0 13 0 0 0 0 0 1
1 0 0 10 12 0 3 6 6 5 0 0 0 0 0 1
1 0 0 1 2 0 2 2 2 1 0 0 0 13 0 1
1 0 0 1 0 0 0 0 0 1 0 0 3 6 6 7
1 0 0 1 0 0 0 0 0 1 0 0 2 2 2 1
1 0 0 1 0 0 0 0 0 1 0 0 0 0 0 1
4 6 6 11 12 0 3 6 6 8 0 0 0 0 0 1
1 2 2 2 2 0 2 2 2 2 0 0 0 0 0 1
1 13 0 0 0 0 13 0 0 0 0 3 6 6 6 7
4 6 6 12 0 0 0 10 12 0 0 2 2 2 2 1
1 2 2 2 0 0 0 1 2 0 0 0 0 0 0 1
1 0 0 0 0 0 0 1 0 0 0 0 0 0 0 1
4 12 0 3 6 6 6 11 6 12 0 0 0 0 0 1
1 0 0 2 2 2 2 2 2 2 0 0 0 0 0 1
1 0 0 0 0 0 0 0 0 0 0 0 13 0 0 1
1 0 13 0 0 13 0 0 0 0 0 0 0 0 0 1
9 6 6 6 6 6 6 6 6 6 6 6 6 6 6 8
2 2 2 2 2 2 2 2 2 2 2 2 2 2 2 2
2 2 2 2 2 2 2 2 2 2 2 2 2 2 2 2