 0 0 0 0 0 0 0
 0 0 0 0 0 0 0
 0 10 6 6 6 5 0
 0 4 2 2 3 7 0
 0 9 6 6 6 8 0
 0 0 0 0 0 0 0
 0 0 0 0 0 0 0